{
    "文盲": {
        "时间": 1,
        "空间": 3,
        "记忆": 2,
        "计算": 1,
        "延迟回忆": 2,
        "命名": 3,
        "复述": 3,
        "执行": 2,
        "阅读": 3,
        "书写": 2,
        "空间结构": 3,
        "阈值": 30
    },
    "小学": {
        "时间": 2,
        "空间": 3,
        "记忆": 2,
        "计算": 1,
        "延迟回忆": 2,
        "命名": 1,
        "复述": 2,
        "执行": 3,
        "阅读": 2,
        "书写": 2,
        "空间结构": 1,
        "阈值": 31
    },
    "中学": {
        "时间": 2,
        "空间": 3,
        "记忆": 2,
        "计算": 2,
        "延迟回忆": 1,
        "命名": 2,
        "复述": 2,
        "执行": 2,
        "阅读": 1,
        "书写": 1,
        "空间结构": 1,
        "阈值": 32
    },
    "大学": {
        "时间": 1,
        "空间": 3,
        "记忆": 2,
        "计算": 2,
        "延迟回忆": 2,
        "命名": 2,
        "复述": 1,
        "执行": 3,
        "阅读": 1,
        "书写": 1,
        "空间结构": 2,
        "阈值": 33
    }
}